႒ = ht
က = k
ခ = kh
ဂ = g
ဃ = gh
င = ng
စ = s
ဆ = x
ဇ = z
စ် = zy
ည = ny
ၫ = ny
ဉ = ny
ဋ = tt
ဌ = htt
ဍ = nd
ဎ = dh
ဏ = nn
တ = t
ထ = ht
ဒ = d
ဓ = dd
န = n
ႏ = n
ပ = p
ဖ = f
ဗ = bb
ဘ = b
မ = m
ယ = i
ရ = y
႐ = y
ရွ = sh
လ = l
ဝ = w
သ = th
ဟ = h
ဠ = nh
အ = a
ဥ = o
