႒ = ht
က = k
ခ = kh
ဂ = g
ဃ = gh
င = ng
စ = s
ဆ = x
ဇ = z
စ် = zy
ည = ny
ၫ = ny
ဉ = ny
ဋ = tt
ဌ = htt
ဍ = hd
ဎ = dh
ဏ = nn
တ = t
ထ = ht
ဒ = d
ဓ = dd
န = n
ႏ = n
ပ = p
ဖ = f
ဗ = b
ဘ = bb
မ = m
ယ = i
ရ = y
ရွ = sh
ရႊ = sh
လ = l
ဝ = w
သ = th
ဟ = h
ဠ = ll
အ = a
ဣ = ???
ဥ = ???
ဧ = ???
